1111111111
1S000001001
11111010101
10000000001
10111111001
10000001001
11111101001
10000001001
10111111E11
11111111111
