1111111111
1D101000C1
1000101011
1010100001
1011111101
1000000101
1111110101
1000000101
10111111E1
1111111111